^^^```""""````"~~~"````````
^^`````""~~"`""""~""````**`
^````"""~~~"`````"~"```**``
```""""~~~~"``````"`````**`
``"~~~"""""````````````````
`"~~~~"````````````````````
`"~~~~"````````````````^^^`
``"~~""``````````````^^^```
```"~~"`````````````^^^^```
```"""```````````````^^^```
````"``````````````````````