```````````````````````````
````````````````````````**`
```````````````^^^`````**``
```""""````````^^^``````**`
``"~~~"````````^^^`````````
`"~~~~"`````░░`````````````
`"~~~~"`````░░░░```````^^^`
``"~~~"``````░░░`````^^^```
```"~~"`````````````^^^^```
````""````````````^^^``````
```````````````````````````