```````````````````````````
````````````````````````**`
```````````````^^^`````**``
```""""````````^^^``````**`
``"~~~"````````^^^`````````
`"~~~~"````````````````````
`"~~~~"````````````````^^^`
``"~~~"``````````````^^^```
```"~~"`````````````^^^^```
````""````````````^^^``````
```````````````````````````